/////////////////////////////////////////////////////
//AppOPsetting.json 파일에 각 값별 기능
//////////////////////////////////////////////////////

// agent 지정한 방식으로 login(siteConfig)
bUseAppLoginType : 사용자 지정 로그인타입 사용 여부 ( true, false )
LoginType : 사용자 지정 로그인타입 지정 (0 = IDPW, 1 = AD, 2 = Ldap, ....)
CustomLoginType : 사이트별 로그인 방식 커스터마이징 
CustomLoginHttpUrl : 로그인 연동을 위한 사이트 URL
NACLoginType : NAC연계 로그인 종류 지정 - 실행 시 전달받은 arg를 이용하여 로그인처리
				0 : NONE (default)
				1 : Genian NAC
NACLoginEncryptKey : NAC연계 로그인 시 인증상태 정보 암호화 키          

// 공통환경설정(일부)

// 로그레벨설정
bUseLogLevel : 로그 레벨 사용자에 의해 수정가능 여부 ( true : 가능, false : 불가능)

// 로그인후 UI 관련
bShowAdminInfo : 대시보드에 관리자 정보 표시 여부(true, false)

// 언어설정
bUseLanguageSet : 공통환경설정에 언어설정 UI가 나오도록 할지 여부(true,false)

// 메인페이지 선택 여부
bUseMainPageType : 공통환경설정에 로그인후 첫화면 선택 설정이 나오도록 할지 여부(true,false)

// 부팅때 자동실행
bUseStartProgramReg : 시작프로그램에 등록하는 체크박스 화면에 표현 여부 [체크박스 Show/Hide]

// 수동다운로드 설정
bManualDownFolderChange : 수동다운로드 폴더선택 체크박스 나오도록 (수동다운로드 서버설정됐을때에만 기능함) (true, false)
bManualRecvDownChange : 수동다운로드 폴더선택 체크박스 설정값(true, false) [기능X]

// 자동다운로드 설정
bMakeRecvDownPathShortCut : 다운로드 수신폴더에 대한 바탕화면 바로가기 생성 여부 (Default : false)

// 우클릭 파일추가 및 자동전송
bRFileAutoSend: 마우스 우클릭 파일 추가 후 자동전송 체크박스 나오도록 (파일전송 사용할때에만 기능함)(true, false)
bRMouseFileAddAfterTrans : 마우스 우클릭 파일 추가 후 자동전송 사용 여부 ( true : 사용, false : 미사용 ) [기능X]

// 사후결재
bShowAfterApprAutoCheck : 사후결재 기본 체크 사용유무 체크박스가 나오도록 (true,false)
bAfterBasicChk : 사후 결재 체크 기본 사용 유무 ( true : 체크, false : 체크 안함 )
bUseApproveAfterLimit : 사후결재 요청에 대한 결재 누적유무 확인해서 차단 ( true : 체크, false : 체크 안함 )



// 트레이 알림 설정
bFileRecvAlarmRetain : 파일 수신후 알림 유지 체크박스 나오도록 (true,false) [기능X, 체크박스만동작]
bFileRecvTrayFix : 파일 수신 알림 트레이 유지 설정값 ( true, false )
bApprCompleteAlarmRetain : 승인완료 알림 유지 체크박스가 나오도록 (true,false) [기능X, 체크박스만동작]
bUserApprActionTrayFix : 승인완료 알림 유지 설정값 (true,false)
bApprRejectAlarmRetain : 반려완료 알림 유지 체크박스가 나오도록 (true,false) [기능X, 체크박스만동작]
bUserApprRejectTrayFix : 반려완료 알림 유지 설정값 (true,false)

bApprCountAlarmRetain : "결재자 승인대기 알림 유지" 체크박스가 나오도록 ( true, false )
bApprTrayFix : 결재자 승인대기 알림 트레이 유지 설정값 ( true, false )
bUseApprCountAlaram : "승인대기 알림설정" 체크박스 나오도록 ( true, false )
bUseApprWaitNoti : 승인대기 알림설정 설정값(true, false)


// IDPW - 자동로그인
bUserIDSave : 로그인하는 사용자ID만 저장하는 option 사용유무 ( true / false )
bUserIDSaveCheck : 사용자ID 체크박스 기본 체크유무 ( true / false )
bAutoLogin : IDPW 자동로그인 기능 사용유무 ( true : 사용, false : 유지 안함 )
bAutoLoginCheck : IDPW 자동로그인 체크박스 기본 체크되어 있게 설정 ( true : 사용, false : 유지 안함 )
bUserPWChange : 사용자pw 변경 기능 사용, PW 검증기능 동시 사용 ( true, false ) ( true, false )
bEmptyfileTrans : 0kb 파일 전송 가능 유무(true, false)
nSessionDuplicate : 로그인시도때 세션중복일때 (-1 : 차단(기본), 0 : 사용자 접속 여부 팝업 표시, 1 : 강제 접속 진행) - Default:0

// IDPW - 관련 기타(siteConfig)
strInitPasswd : 암호화된 초기 PW string
strPWChangeProhibitLimit : 패스워드 사용금지 문자열 [기능 X]
nPWChangeApplyCnt : 비밀번호 변경때, 새비번의 최소길이 (기본값:9)
bUseIDAsInitPassword : ID와 동일한 비밀번호를 초기 PW로 사용할지 여부 (true : ID=PW로 로그인된 경우, 비밀번호 변경 요청)
bUseLoginCI : 로그인 화면 상단에 CI 이미지 표시 여부 (Default : false)

// URL자동전환
bURLAutoTrans : URL 자동전환 사용 유무 (망별로) ( true : 사용, false : 미사용 )
strURLAutoAfterBrowser :  : URL 자동전환 Type (망별로) (URLLIST에 있는 domain 방문시 이 브라우저 창을 어떻게 처리할지 결정, C :  닫음, F : 특정URL로 이동, N : 그냥둠)
bURLAutoAfterMsg : URL 자동전환 후 사용자 알림 메시지 사용 여부(망별로) ( true : 사용, false : 미사용 )
strForwardUrl : URL 자동전환 후 브라우저 창 Forward 할 주소 저장 ( F방식일대에만 사용 : 포워딩할 URL )

// 클립보드 - 파일형태로 전송(siteConfig)
bUseClipBoardFileTrans : 파일형태로 클립보드를 송신할지유무, (true : 파일전송기능으로 클립보드 내용 전달, false : 예전에 실시간 클립보드 전송기능 사용)
bUseFileClipManageUI : 파일형태로 클립보드 송수신할때, 클립보드 관리 UI를 나오도록할지 유무(true: 클립보드 전송관리UI 있음, false : 없음)
bUseFileClipApproveUI : 파일형태로 클립보드 송수신할때, 클립보드 결재 UI를 나오도록할지 유무(true: 클립보드 결재관리UI 있음, false : 없음)

// 화면잠금
// bScreenLockUserChange : 스크린 잠금 사용자가 설정가능 체크박스 나오도록 ( true, false )(사용안함)
// bScreenLock : 화면잠금 사용 여부.(체크박스값) (true, false)(사용안함)
strScrTimeoutLockType : ScrLockTime의 시간초과로 타임아웃 발생 시, 처리타입 (ScreenLock:화면잠금, LogOut:로그아웃, Exit: 프로그램 종료) - Default:ScreenLock


// 기타 (1)
enMainPageType : 로그인후 메인페이지 (0,1 : DASHBOARD, 2 : TRANSFER | 파일전송 , 3 : TRANSMANAGER_FILE | 파일전송관리, 4 : TRANSMANAGER_CLIP | 클립보드관리, 5 : TRANSMANAGER_EMAIL | 메일관리)
bNoApproveManageUI : 모든 기능 결재관리 UI 않나오도록함.(보안결재 제외, true : 결재관리UI 들 안나옴, false : 나옴)(siteConfig)
bUseApproveManageUIForce : 서버 설정과 상관없이 결재관리 페이지가 나오게 설정
bStartProgramReg : 시작 프로그램 등록 ( true : 부팅때 OpenNetLink 실행, false : 부팅때 OpenNetLink 실행 등록 해제 ) [기능X]
bTitleDescSameChk : 파일 전송 시 제목과 설명의 연속된 동일 문자 체크 여부 [기능X]

bUseFileCheckException : 파일검사 예외 신청 기능 활성화유무 (true, false)
bUseNetOverAllsend : 3망상황에 모든 망에 파일, 클립보드 보내는 기능 활성화(true,false) [기능이상 가능성 높음, Server필요]
listUseGpkiLogin : GPKI 로그인 사용 여부(망별로 로그인시 사용하는 기능) [기능이상 가능성 높음, Server필요] 
bClipBoardNoApproveButFileTrans : 클립보드 파일전송으로 보낼때, 권한상관없이 결재없이 송신할수 있도록 설정(siteConfig)
bUseDenyPasswordZip : zip 파일에 비번걸려있을때에 차단 (true, false)(siteConfig)

bRecvFolderChange : 공통환경설정에서 수신폴더 변경가능하게 하는 버튼 show 유무 결정(true, false)(siteConfig)

bUseCertSend : 공인인증서 전송기능 사용유무 (true,false) [기능X]

bUseEmail : email 관리 / 결재 UI 나오도록 할지 여부 (true, false)
bUserEmailSearchDlp : email 관리 / 결재 UI에서 개인정보 관련 부분 표현 및 검색되게할지 유무 (true, false)
bUseEmailOnly : email 관리 / 결재 UI 를 중점적으로 사용하도록 UI 메뉴 수정 여부 (true, false)

bUseForceUpdate : 업데이트할 항목이 있으면 사용자 의사 관계없이 강제 업데이트 진행여부(true,false)

bUseForceBackgroundUpdate : 업데이트할 항목이 있으면 사용자 의사 관계없이 Background로 강제 업데이트 진행여부(true,false)

bUsePCURL : PCUrl 관련 화면 나오게할지 여부 [기능X, 화면만 일부 있음]

bUsePublicBoard : 공지사항 관련 화면 나오게 할지 여부 [기능일부있음]

bUseUserRecvDownPath : 수신경로에 로그인한 사용자ID folder를 만들어서 거기에 download 하도록 설정 유무(true,false)

bUseUserSelectFirstServer : 다중망 로그인 상황 일때에 사용자가 1, 2번째 망중먼저 로그인할 망을 선택할 수 있는 화면과 기능제공 여부(true, false)

bViewDlpApproverSelectMyDept : 정보보호 결재자 자기부서 사람만 조회되도록 유무(true, false) [기능 X]

bViewFileFilter : 환경설정에 확장자 제한 정보 표현여부(true,false)

bViewSGHeaderUIAlarmNoriAllDel : 알람 / 노티 한번에 삭제하는 기능 제공유무(true,false)

bViewSGSideBarUIBadge : 왼쪽 siteBar에 BadgeUI 나오게할지 여부(true,false) [기능을 사용할때마다 나와서 보통false사용]

nClipAfterApproveUseType : 클립보드 파일전송 형태때, 0:CheckBox 및 사용자 설정 설정대로, 1:사전, 2:사후 로 전송되게 적용 (사후결재 체크여부를 확인한다.)

bUseOneToMultiLogin : 1번에 다중망 로그인 기능 사용유무
bUseOneByOneLogOut : 1번에 다중망 로그인 기능 사용중일때, 로그아웃은 선택한 망에 대해서 1곳만 진행(true)
bAllowDRM : DRM 파일 전송 허용 여부 (true : 전송, false : 차단) - Default : true

// 결재자 및 결재 관련
bApprDeptSearch : 결재자 검색 창의 타부서 수정 가능 여부. ( true, false )(siteConfig)
bApprLineChkBlock : 고정 결재라인 사용할때, 결재라인이 존재하지 않는 사용자에 대해 파일 전송 차단 여부(결재자를 추가하라는 메세지 발생유무) ( true : 전송 차단, false : 전송 허용 )(siteConfig)
bApprLineLocalSave : 결재라인 로컬 저장 여부  ( true, false )

// 클립보드 - 기타
bUseClipAlarmType : 공통환경설정에서 클립보드 송수신 알림형식 수정가능 유무 (true,false)
bUseClipCopyAndSend : 공통환경설정에서 클립보드 복사 후 전송 체크박스가 나오도록 ( true, false ) [기능X, 체크박스만동작]
bClipCopyAutoSend : 클립보드 복사 후 전송 체크박스 설정값(true, false)

// APP 트레이 이동 설정
bUseCloseTrayMove : 공통환경설정에서 종료 시, 트레이로 이동 체크박스가 나오도록 ( true, false )
bExitTrayMove : 오른쪽 상단에 종료버튼으로 종료 시도시 Tray로 이동만 할지 여부(true: Tray로 이동, false: 종료)

bUseStartTrayMove : 공통환경설정에서 시작 시 트레이 이동 체크박스가 나오도록 ( true, false )


// 파일포워딩 기능
bUseFileForward : 파일포워드 기능 사용유무(true, false)(siteConfig)
bFileDownloadBeforeReciving : 파일포워드, 송신자가 수신PC에 미수신한 상태에서도 포워드수신자들이 수신다운로드 가능 유무(true, false)


// 기타 (2)
bRecvFolderOpen : 파일 수신후 폴더 열기 사용유무
bUseAgentTime1aClock : 정책값대로 시간단위 사후결재 정책, 자정에  검색화면 검색날짜 UI / 일일 송순가능수 UI 변경되는거 Server 시간이 아니라 agent 시간기준으로 동작함(true:사용,false:않함) - Test 목적(siteConfig)
strOKTAUrl : OKTA 연동 URL (URL 입력 시, 인증 화면으로 해당 URL 브라우저 표시 및 리다이렉션 된 사용자정보로 인증)

// 부서별 사용자 조회 방식 설정 기능(siteConfig)
strApproverSearchType :	'파일전송' 화면에서 결재자 선택 시 사용자 조회 방식을 결정 
						=> "SEARCH" : 입력된 부서명과 사용자명을 기반으로 결과 리스트 표시 (Default)
						=> "TREE" : 부서 TREE가 추가로 표시되며 부서별로 결과 리스트 표시 (해당 설정 시 bApprDeptSearch 옵션 무효화)
bUseInputSearchInApproverTree : strApproverSearchType옵션이 "TREE" 일 경우, 부서명과 사용자명을 검색할 수 있는 컨트롤 표시 여부 (true,false)

strReceiverSearchType:	'파일전송' 화면에서 수신자 선택 시 사용자 조회 방식을 결정 
						=> "SEARCH" : 입력된 부서명과 사용자명을 기반으로 결과 리스트 표시 (Default)
						=> "TREE" : 부서 TREE가 추가로 표시되며 부서별로 결과 리스트 표시 (해당 설정 시 bApprDeptSearch 옵션 무효화)
bUseInputSearchInReceiverTree: strReceiverSearchType "TREE" 일 경우, 부서명과 사용자명을 검색할 수 있는 컨트롤 표시 여부 (true,false)
 
strProxySearchType:	'대결재자 관리' 화면에서 대결재자 선택 시 사용자 조회 방식을 결정 
						=> "SEARCH" : 입력된 부서명과 사용자명을 기반으로 결과 리스트 표시 (Default)
						=> "TREE" : 부서 TREE가 추가로 표시되며 부서별로 결과 리스트 표시 (해당 설정 시 bApprDeptSearch 옵션 무효화)
bUseInputSearchInProxyTree: strProxySearchType "TREE" 일 경우, 부서명과 사용자명을 검색할 수 있는 컨트롤 표시 여부 (true,false)

strSecurityApproverSearchType:	'보안결재자 선택' 화면에서 보안결재자 선택 시 사용자 조회 방식을 결정 
						=> "SEARCH" : 입력된 부서명과 사용자명을 기반으로 결과 리스트 표시 (Default)
						=> "TREE" : 부서 TREE가 추가로 표시되며 부서별로 결과 리스트 표시 (해당 설정 시 bApprDeptSearch 옵션 무효화)
bUseInputSearchInSecurityApproverTree: strSecurityApproverSearchType "TREE" 일 경우, 부서명과 사용자명을 검색할 수 있는 컨트롤 표시 여부 (true,false)

ApproveExtApproverSearchType: '필수 결재 기능'에서 결재자 선택하는 방식
						=> "SEARCH" : 입력된 부서명과 사용자명을 기반으로 결과 리스트 표시 (Default)
						=> "TREE" : 부서 TREE가 추가로 표시되며 부서별로 결과 리스트 표시 (해당 설정 시 bApprDeptSearch 옵션 무효화)
bUseApproveExt: 필수 결재 기능 사용유무(siteConfig)
bUseInputSearchApproveExtTree : 필수 결재 기능 에서 "TREE" 일 경우, 부서명과 사용자명을 검색할 수 있는 컨트롤 표시 여부 (true,false)

bUsePartialFileAddInTransfer: '파일전송' 화면에서 등록시도한 파일목록에 정상파일과 오류파일이 함께 존재할 시 정상 파일에 대한 부분 등록 가능여부(true, false)
						=> true : 오류파일을 제외하고 정상파일만 등록된다.
						=> false : 목록에 오류파일이 1개 이상 존재하는 경우, 목록이 모두 등록되지 않는다.
bUseInitAlarmPerDay :  현 시점을 기준(날짜)으로 이전 알람 삭제
						=> true : 매일 이전의 알람을 삭제
						=> false : 삭제하지 않는다.
bUseInitMessagePerDay : 현 시점을 기준(날짜)으로 이전 메세지 삭제
						=> true : 매일 이전의 메세지을 삭제
						=> false : 삭제하지 않는다.
bVisiblePolicyUpdateButton : SGHeaderUI 에서 정책업데이트 버튼 보여주는 여부
						=> true : 보여준다
						=> false : 보여주지 않는다.
bUseChkHardSpace : 파일 수신시 디바이스 용량 체크 여부

bUseOver1Auth : AD로그인 실패시, IDPW 로그인시도할수 있게 Login UI 설정 및 동작(자동로그인X)

bUseLoginAfterTray : 로그인 후 Tray로 이동, bStartTrayMove 이 옵션과 혼동해서 사용 금지, 로그인 후 Tray 로 이동과 프로그램 시작시 Tray로 이동

bUseFileApproveReason: 파일 전송 승인시 승인사유 입력 여부

bUseClipBoardApproveReason : 클립보드 전송 승인시 승인 사유 입력 여부

bUseFileSelectDelete : 파일 선택 삭제 사용 유무

bUseCrossPlatformOSforFileName : 파일이름에 OS간에 사용할수 없는 문자 들어간거 차단하는기능 사용유무(Linux 간에만 사용한다든지 할때는 false 해도 무관)

bUseTitleDescMinLength : 제목 / 설명 글자 최소 글자수 서버 DB에서 받아서 동작하게 설정

InitTransferFileExplorerDirectoryInWindow : 윈도우에 한하여 전송화면에서 좌측에 초기 표시할 기본 경로 (Default : "")
											=> "ROOT" : 상위 드라이버를 초기 표시											
											=> "" : 기본 경로를 표시.
											=> 그 밖에 사용자가 원하는 경로로 설정 가능
bUseGoogleOtp2FactorAuth : 구글OTP를 사용한 인증동작 하도록 수정적용

bDlpFoundSendContinue : 개인정보 검출 됐을때, 정보보호 결재자 없이 현재결재자에게 결재받고 송신되도록 할지 유무(기본값-false)

bUseAllProxyAuthority : 대결재자로서, 원결재자의 모든 권한을 위임받아 사용할지 유무

bUseFileTrans : 자료 전송 대메뉴 사용 여부
bUseClipTypeText : TEXT로 클립보드 전송 사용 유무

bUseClipTypeImage : IMAGE로 클립보드 전송 사용 유무

bHiddenLoginLogo : Main Login 창 좌측 로고 숨김 처리
bUseDrmAfterFileReceive :           //파일 수신 완료 후 DRM 사용 여부
nDrmType :                          //DRM 종류 - 1. SoftCamp, 2.Fasso
strSoftCampGrade:                   // SoftCamp 연동 시 보안등급
bHideApprLine : 파일전송에 결재라인 UI상에 숨길지 유무 (true:숨김, 기본값: false)
bHideTitleDesc : 파일전송에 제목/설명 UI상에 숨길지 유무 (true:숨김, 기본값: false)

nTransferTemplate : 파일전송 UI 템플릿 지정 (Default : 0)
								=> 0 : 기존 전송 템플릿
								=> 1 : 제목/설명입력항목이 없고, 상단에는 드래그 리스트/ 하단에는 정렬가능한 파일목록 표시

bUseDashBoard : 공통환경설정에서 dashboard 를 첫화면으로 사용하지 못하게 함(true:사용, 기본값:true)
bUseEmailApprUIwait : Email결재관리 화면으로 이동하면 승인대기 조건으로 검색하게 할지 유무(true:사용, 기본값:false)
strVirusAptDetailCustomMsg : 바이러스 / APT 검사결과의 상세설명에 나오게할 커스텀 문구(html 형태로 표현가능), 없으면 기본문구표현
bUseAskFileSendAlert : 파일리스트 추가 후 전송을 묻는 팝업표시 기능 활성화 여부 (Default : false)

bUseCommonEnvNetNameRevert : 공통환경설정에 수신경로 망별이름을 from > to 에서 to > from 으로 표현현 유무(Default : false)

bUseUnZipForTransfer :    파일 전송 시 압축 파일 해제하여 전송(Default : false)

bUseCheckZipFileInnerFileCount : 1회 전송 가능 파일 검사 시 Zip 파일일 경우 내부 파일 전체를 Count에 포함(Default : false)








